Rank	Nation	Gold	Silver	Bronze	Total
1	Canada	25	18	14	57
2	Scotland	18	6	13	37
3	Sweden	8	18	9	35
4	Switzerland	6	9	10	25
5	United States	4	3	10	17
6	Russia	2	1	2	5
7	Norway	1	2	4	7
8	Denmark	1	1	5	7
9	Germany	0	2	3	5
10	Japan	0	2	1	3
11	France	0	1	1	2
12	Czech Republic	0	1	0	1
12	Finland	0	1	0	1
14	Italy	0	0	1	1
Total	Total	65	65	73	203
