R	Player	Position	League	Champions League	Coppa Italia	Super Coppa	Total
1	Milito	CF	22	6	2	0	30
2	Eto'o	CF	12	2	1	1	16
3	Balotelli	WF	9	1	1	0	11
4	Sneijder	AM	4	3	1	0	8
5	Maicon	RB	6	1	0	0	7
6	Stanković	CM	3	2	0	0	5
7	Motta	DM	4	0	0	0	4
7	Cambiasso	DM	3	1	0	0	4
7	Samuel	CB	3	1	0	0	4
10	Pandev	WF	3	0	0	0	3
11	Lúcio	CB	1	0	1	0	2
12	Chivu	LB	1	0	0	0	1
12	Mariga	CM	1	0	0	0	1
12	Muntari	CM	1	0	0	0	1
12	Vieira	CM	1	0	0	0	1
