Rank	Nation	Gold	Silver	Bronze	Total
1	United States	30	18	6	54
2	Canada	3	9	12	24
3	Cuba	2	3	7	12
4	Venezuela	0	2	0	2
5	Mexico	0	1	2	3
6	Brazil	0	1	1	2
6	Colombia	0	1	1	2
8	Jamaica	0	0	3	3
9	Trinidad and Tobago	0	0	1	1
9	Peru	0	0	1	1
9	Argentina	0	0	1	1
