Rank	Nation	Gold	Silver	Bronze	Total
1	Japan	4	3	3	10
2	South Korea	3	0	2	5
3	Poland	2	0	0	2
4	Germany	1	1	4	6
5	China	1	1	2	4
5	Great Britain	1	1	2	4
7	Hungary	1	1	0	2
8	Cuba	1	0	3	4
8	France	1	0	3	4
10	Belgium	1	0	0	1
11	Georgia	0	1	2	3
11	Netherlands	0	1	2	3
13	Brazil	0	1	1	2
13	Spain	0	1	1	2
13	United States	0	1	1	2
16	Azerbaijan	0	1	0	1
16	Canada	0	1	0	1
16	Israel	0	1	0	1
16	Switzerland	0	1	0	1
20	Russia	0	0	4	4
21	Romania	0	0	1	1
21	Italy	0	0	1	1
