Draw	Artist	Song	Jury	Televote	Total	Place
1	Lowry	"You Ain't What I Need"	6	8	14	4
2	Janne Saar	"I Am Too Good For You"	8	4	12	5
3	StereoChemistry	"Öösiti kõndides"	2	1	3	10
4	Urban Symphony	" Rändajad "	10	9	19	1
5	Chalice & Maagiline kuues	"Nelikümmend"	3	5	8	7
6	Köök & Kaire Vilgats	"Üürnik"	4	2	6	9
7	Rolf Junior	"Freedom"	1	6	7	8
8	Traffic	"See päev"	9	7	16	2
9	Ithaka Maria	"One Last Dance"	7	3	10	6
10	Laura	"Destiny"	5	10	15	3
