Player	League	Scottish Cup	League Cup	Challenge Cup	Total
Gary Harkins	9	1	1	1	12
Liam Buchanan	6	1	0	0	7
Stephen McKeown	3	0	2	2	7
Kris Doolan	5	0	0	0	5
Ian Maxwell	3	0	1	0	4
Scott Chaplain	2	1	1	0	4
Damon Gray	1	0	2	1	4
Paul Paton	3	0	0	0	3
Kevin McKinlay	2	0	0	0	2
Simon Donnelly	1	0	0	1	2
John Robertson	1	0	0	0	1
David Rowson	1	0	0	0	1
Lucas Akins	1	0	0	0	1
Mark Roberts	0	0	0	1	1
Chris Turner	0	0	0	1	1
Marc Twaddle	0	0	0	1	1
