Rank	Nation	Gold	Silver	Bronze	Total
1	Algeria	6	3	4	13
2	Tunisia	6	3	2	11
3	Egypt	2	4	1	7
4	Morocco	2	0	6	8
5	Senegal	0	1	4	5
6	South Africa	0	1	3	4
7=	Madagascar	0	1	2	3
7=	Nigeria	0	1	2	3
9	Democratic Republic of the Congo	0	1	1	2
10	Libya	0	1	0	1
11	Cameroon	0	0	4	4
12	Mauritius	0	0	2	2
13	Angola	0	0	1	1
